{
    "legend": {
        "0": "floor",
        "1": "dice",
        "2": "player",
        "3": "void",
        "4": "end",
        "5": "wall"
    },
    "die": {
        "1": {
            "TOP": 1,
            "BOTTOM": 6,
            "UP": 2,
            "DOWN": 5,
            "LEFT": 4,
            "RIGHT": 3
        }
    },
    "map": [
        "555555555555555555555555555555555555555555555555",
        "555555555555555555555555555555555555555555555555",
        "555555555555555555555555555005555555555555555555",
        "555555555555555555555555500000003003300000455555",
        "555555555555555550005555500000503055555555555555",
        "555550000055550000000555550055553555555555555555",
        "555550000055550350000555555555553555555555555555",
        "555550210055555350005555555555553555555555555555",
        "555550000055555355535550055550000555555555555555",
        "555550000033333355500000055550000555555555555555",
        "555555555555550055000000033330000555555555555555",
        "555555555555555555000555555550000555555555555555",
        "555555555555555555555555555555555555555555555555",
        "555555555555555555555555555555555555555555555555",
        "555555555555555555555555555555555555555555555555"
    ]
}